00000000000000000010000000011111111111111000000000000000000000000000000000000001111100000000011111111111111110100000000000000000000000010010000000000000010000000110000000000
00000000000000000011111111111000000100001000000000000000000000000000000000000010000111000011101100000000000010111111111111111111111111110010000000000000010000000110000000000
00000000000000000010000000000000001000001000000000000000000000000000000000000010000000111100001100000000000010100000000022200000000000010010000000000000010000000110000000000
00000000000000000010000000000000010000000100000000000000000000000000000000000010000000000000001100000000000010100000000000000000000000010010000000000000010000000110000000000
00000000000000000010000000000000100000000100000000000000000000000000000000000100000000000000001100000000000010100000000000000000000000010010000000000000010000000110000000000
00000000000000000010000000000111000000000100000000000000000000000000000000000100000000000000001100000000000010100000000000000000000000010010000000000000210000000110000000000
00000000000000000010000000001000000000000100000000000000000000000000000000001100000000000000001100000000000010100000000000000000000000010010000111111100210000000110000000000
00000000000000000010000000010000000000000100000000000000000011111111111100001000000000000000001100000000000010100000000000000000000000010010000100000100211111111100000000000
00000000000000000010000000100000000111111100000000000111111100000000000111011000000000000000001100000000000010100000000000000000000000010010000100000100010000000000000000000
00000000000002222210000000100000000100000000000000011000000000000000000000110000000000000000001100000000000010100000000000000000000000010010000100000100010000000000000000000
00000000000001111110000001000000000100000000000000100000000000000000000000110000000000000000001100000000000010100000000000000000000000210010000100001111110000000000000000000
00000000000000000010000001000000000100000000000000100000000000000000000000100000000000000000001100000000000010100000000000000000000000210010000100001000010000000000000000000
00000000000000000010000001000000000100000000000001000000000000000001111111100000000000000000001100000000000010100000000000000000000000210010000100001000010000000000000000000
00000000000000000010000001000000000100000000000001000000000000000000000001100000000000000000001100000000000010100000000000000000000000010011111100001000011111111111111000000
00000000000000000010000001000000000111111111111101000000000000000000000001000000000000000000001100000000000010100000000000000000000000010010000000001000010000000000000000000
00000000000000000010000011111111111100000000000010000000000000000000000001000000000000000000111100000000000010100000000000000000000000010010000000001000010000000000000000000
00000000000000000010000000001000011100000000000010000000000000000000000001000000000000000011001100000000000010100000000000000000000000010010000000001000010000000000000000000
00000000000000000010000000001000000011100000000010111111100000000000000010000000000000001100001100000000000010100000000000000000000000010011111111001000010000000000000000000
00000000000000000010000000001000000000011100000010100000000000000000000010000000000000110000000100000000000010100000000000000000000000010010000001001000010000000000000000000
00000000000000000010000000001000000000000011100100100000000000000000000010000000000001100000000100000000000010100000000000000000000000010010000001001000010000000000000000000
00000000000000000010000000001000000000000000111100100000000000000000000010000000000110000000000100000000000010100000000000000000000000010010000001001000010000000000000000000
00000000000000000010000000011111111110000000000111100000000000000000000010000000011000000000000110000000000010100000000000000000000000010010000001001000010000000000000000000
00000000000000000010000000010000001000000000000100111110000000000000000010000001100000000000000101000000000010100000000000000000000000010010000001001000010000000000100000000
00000000000000000010000000010000001000000000000100100001111000000000000100000110000000000000000100100000000010100000000000000000000000010010000001011000010000000000010000000
00000000000000000010000000010000001000000000000100100000000111111111111111111000000000000000000100010000000010111111100000000000000000010010000001010000010000000000010000000
00000000000000000010000000010000001000000000000100100000000000000000000100000100000000000000001000001000000010100000110000000000000000010011111111110000010000000000010000000
00000000000000000010000000010000001000000000000000100000000000000000000100000100000000000000001000001000000010100000110000000000000000010010000000000000011111111111110000000
00000000000000000010000000010000001000000000000001000000000000000000000100000100000000000000001000001000000010100000110000000000000000010010000000000000010000000000000000000
00000000000000000010000000010000001000000000000001000000000000000000000100000010000000000000001000001000000010100000001000000000000000010010000000000000010000000000000000000
00000000000000000010000000010000001000000000000001000000000000000000000100000001000000000000001000000100000010100000001000000000000000010010000000000000010000000000000000000
00000000000000000010000000010000001000000000000010000000000000000000000100000000110000000000001000000100000010100000001200000000000000010011111110000100010000000000000000000
00000000000000000010000000010000001000000000000010000000000000000000000100000000001000000000010000000100000010100000001200000000000000010010000010000100011111111111110000000
00000000000000000010000000010000001000000000000010000000000000000000000100000000000110000000010000000100000010100000001200000000000000010010000010000100010000000000000000000
00000000000000000010000000010000001000000000000010000000011111111100000100000000000001100000010000000100000010100000001000000000000000010010000010000100010000000000000000000
00000000000000000010000000010000001000000000000010000000000000000011111100000000000000010000010000000100000010100111111000000000000000010010000010000100010000000000000000000
00000000000000000011111111110000001000000000000010000000000000000000010111101000000000001100010000000010000010100100000000000000000000010010000010000100010000000000000000000
00000000000000000100000000010000001000000000000010000000000000000000110000111000000000001110010000000010000010100100000000000000000000010010000010000100010000000000000000000
00000000000000000100000000010000001111111111111111111100010000000000100000001000000000001011110000000010000010100100000000000000000000010010000011111111110000000000000000000
00000000000000000100000000010000001000000000000010000111110000000000100000001000000000010011010000000010000010100100000000000000000000010010000010000000010000000000000000000
00000000000000000100000000010000011000000000000010000100010000000000100000001000000000100111101000000001000010100100000000000000000000010010000010000000010000000000000000000
00000000000000000100000000010000010000000000000010000100001000000000100000001000000001001111010110000001000010100100000000000000111111110010000010000000010000000000000000000
00000000000000000100111111111111110000000000000010000100001000000000100000001000000001001011010001000001000010100100000000000000100000010010000000000000010000000001000000000
00000000000000000100100000000000000000000000000010000100001000000000100000001000000021111111111111100001000010100100000000000000100000010010000000000000010000000001000000000
00000000000000000100100000000000000000000000000010000100001000000000100000001000000021111111111111111111111110100100000000000000100000010010000000000000010000000001000000000
00000000000000001000100000000000000000000000000010001100001000000000100000001000000021001001001001000000000110100100000000000000100000010010000000000000010000000001000000000
00000000000000001000100000000000000000000000000011110000001000000000100000001000000001001001010010000000000110100100000000000000100000010010000000000000010000000001000000000
00000000000000001000100000000000000000000000000010000000001000000000100000001000000001000101110100000000000111111100000000000000100000011111111111111111111111111111111111111
00000000000000001000100000000000000000000000000010000000001000000000100000001000000000100011111000000000000010100111111111111111100000010010000000000000010000000001000000000
00000000000000001001000000000000000000000000000111111111111111111111112222201000000000010001100000000000000010100012000000000000000000010010000000000000010000000001000000000
00000000000000001001000000000000000000000000000100000000001100000000111111111000000000001010000000000000000010100012000000000000000000010010000000000000010000000001000000000
00000000000000001001000000000000000000000000000100000000001011000021001011110000000000001100000000000000000010100012000000000000000000010010000000000000010000000001000000000
00000000000000001001000000000000000000000000000100000000001000100021000110000000000000001100000000000000000010100010000000000000000000010010000000000000010000001110000000000
00000000000000011011000000000000000000000000000100000000001000010110000010000000000000111010000000000000000010100010000000000000000000010010000000000000010000001000000000000
00000000000000010010000000000000000000000000000100000000001000111000000010000000000001100001000000000000000010100010000000000000000000010010000000000000010000001000000000000
00000000000000100010000000000000000000000000000100000000001001100100000010000000000010000000100000000000000010100010000000000000000000010010000000000000010000001000000000000
00000000000000100100000000000000000000000000000100000000002110000011000010000000001100000000010000000000000010100010000000000000000000010010000000000000010000001000001111111
00000000000000100100000000000000000000000000000100000000002000000001000010000000011000000000010000000000000010100010000000000000000000010010000000000000010000001000011000000
00000000000000101000000000000000000000000000000100000000002111111111111110000000110000000000001000000000000010100010000000000000000000010010000000000000010000001000010000000
00000000000000101000000000000000000000000000000100000000002110000000000010000001000000000000000100000000000010100010000000000000000000010010000000000000010000001111110000000
00000000000000101000000000000000000000000000000100000000002001110000000010000010000000000000000100000000000010100010000000001111110000010010000000000000010000000000010000000
00000000000000101000000000000000000000000000000100000000001000001100000010000110000000000000000100000000000010111111111111111000010000010010000000000000010000000000010000000
00000000000001101000000000000000000000000000000100000000001000000011000010000100000000000000000100000000000010100000000000001000010000010010000000000000010000000000010000000
00000000000001001000000000000000000000000000000100000000001111111111111111111100000000000000000100000000000010100000000000001000010000010010000000011111110000000000000000000
00000000000001001000000000000000000000000000000100000000001000002222200111100000000000000000000100000000000010100000000000001000010000010010000000010000010000000000000000000
00000000000001001000000000000000000000000000000100000000001000000000000100011100000000000000000100000000000010100000000000001000011111111111111111110000010000000000000000000
00000000000001001000000000000000000000000011111111111111111000000000000100000011100000000000000100000000000010100000000000001000000000010010000000000000010000000000000000000
00000000000001001000000000000000000000000000000000000000000000000000000100000000011100000000000100000000002210100000000000001000000000010010000000000000010000000000000000000