11111111111111111101111111100000000000000111111111111111111111111111111111111110000011111111100000000000000001011111111111111111111111101101111111111111101111111001111111111
11111111111111111100000000000111111011110111111111111111111111111111111111111101111000111100010011111111111101000000000000000000000000001101111111111111101111111001111111111
11111111111111111101111111111111110111110111111111111111111111111111111111111101111111000011110011111111111101011111111122211111111111101101111111111111101111111001111111111
11111111111111111101111111111111101111111011111111111111111111111111111111111101111111111111110011111111111101011111111111111111111111101101111111111111101111111001111111111
11111111111111111101111111111111011111111011111111111111111111111111111111111011111111111111110011111111111101011111111111111111111111101101111111111111101111111001111111111
11111111111111111101111111111000111111111011111111111111111111111111111111111011111111111111110011111111111101011111111111111111111111101101111111111111201111111001111111111
11111111111111111101111111110111111111111011111111111111111111111111111111110011111111111111110011111111111101011111111111111111111111101101111000000011201111111001111111111
11111111111111111101111111101111111111111011111111111111111100000000000011110111111111111111110011111111111101011111111111111111111111101101111011111011200000000011111111111
11111111111111111101111111011111111000000011111111111000000011111111111000100111111111111111110011111111111101011111111111111111111111101101111011111011101111111111111111111
11111111111112222201111111011111111011111111111111100111111111111111111111001111111111111111110011111111111101011111111111111111111111101101111011111011101111111111111111111
11111111111110000001111110111111111011111111111111011111111111111111111111001111111111111111110011111111111101011111111111111111111111201101111011110000001111111111111111111
11111111111111111101111110111111111011111111111111011111111111111111111111011111111111111111110011111111111101011111111111111111111111201101111011110111101111111111111111111
11111111111111111101111110111111111011111111111110111111111111111110000000011111111111111111110011111111111101011111111111111111111111201101111011110111101111111111111111111
11111111111111111101111110111111111011111111111110111111111111111111111110011111111111111111110011111111111101011111111111111111111111101100000011110111100000000000000111111
11111111111111111101111110111111111000000000000010111111111111111111111110111111111111111111110011111111111101011111111111111111111111101101111111110111101111111111111111111
11111111111111111101111100000000000011111111111101111111111111111111111110111111111111111111000011111111111101011111111111111111111111101101111111110111101111111111111111111
11111111111111111101111111110111100011111111111101111111111111111111111110111111111111111100110011111111111101011111111111111111111111101101111111110111101111111111111111111
11111111111111111101111111110111111100011111111101000000011111111111111101111111111111110011110011111111111101011111111111111111111111101100000000110111101111111111111111111
11111111111111111101111111110111111111100011111101011111111111111111111101111111111111001111111011111111111101011111111111111111111111101101111110110111101111111111111111111
11111111111111111101111111110111111111111100011011011111111111111111111101111111111110011111111011111111111101011111111111111111111111101101111110110111101111111111111111111
11111111111111111101111111110111111111111111000011011111111111111111111101111111111001111111111011111111111101011111111111111111111111101101111110110111101111111111111111111
11111111111111111101111111100000000001111111111000011111111111111111111101111111100111111111111001111111111101011111111111111111111111101101111110110111101111111111111111111
11111111111111111101111111101111110111111111111011000001111111111111111101111110011111111111111010111111111101011111111111111111111111101101111110110111101111111111011111111
11111111111111111101111111101111110111111111111011011110000111111111111011111001111111111111111011011111111101011111111111111111111111101101111110100111101111111111101111111
11111111111111111101111111101111110111111111111011011111111000000000000000000111111111111111111011101111111101000000011111111111111111101101111110101111101111111111101111111
11111111111111111101111111101111110111111111111011011111111111111111111011111011111111111111110111110111111101011111001111111111111111101100000000001111101111111111101111111
11111111111111111101111111101111110111111111111111011111111111111111111011111011111111111111110111110111111101011111001111111111111111101101111111111111100000000000001111111
11111111111111111101111111101111110111111111111110111111111111111111111011111011111111111111110111110111111101011111001111111111111111101101111111111111101111111111111111111
11111111111111111101111111101111110111111111111110111111111111111111111011111101111111111111110111110111111101011111110111111111111111101101111111111111101111111111111111111
11111111111111111101111111101111110111111111111110111111111111111111111011111110111111111111110111111011111101011111110111111111111111101101111111111111101111111111111111111
11111111111111111101111111101111110111111111111101111111111111111111111011111111001111111111110111111011111101011111110211111111111111101100000001111011101111111111111111111
11111111111111111101111111101111110111111111111101111111111111111111111011111111110111111111101111111011111101011111110211111111111111101101111101111011100000000000001111111
11111111111111111101111111101111110111111111111101111111111111111111111011111111111001111111101111111011111101011111110211111111111111101101111101111011101111111111111111111
11111111111111111101111111101111110111111111111101111111100000000011111011111111111110011111101111111011111101011111110111111111111111101101111101111011101111111111111111111
11111111111111111101111111101111110111111111111101111111111111111100000011111111111111101111101111111011111101011000000111111111111111101101111101111011101111111111111111111
11111111111111111100000000001111110111111111111101111111111111111111101000010111111111110011101111111101111101011011111111111111111111101101111101111011101111111111111111111
11111111111111111011111111101111110111111111111101111111111111111111001111000111111111110001101111111101111101011011111111111111111111101101111101111011101111111111111111111
11111111111111111011111111101111110000000000000000000011101111111111011111110111111111110100001111111101111101011011111111111111111111101101111100000000001111111111111111111
11111111111111111011111111101111110111111111111101111000001111111111011111110111111111101100101111111101111101011011111111111111111111101101111101111111101111111111111111111
11111111111111111011111111101111100111111111111101111011101111111111011111110111111111011000010111111110111101011011111111111111111111101101111101111111101111111111111111111
11111111111111111011111111101111101111111111111101111011110111111111011111110111111110110000101001111110111101011011111111111111000000001101111101111111101111111111111111111
11111111111111111011000000000000001111111111111101111011110111111111011111110111111110110100101110111110111101011011111111111111011111101101111111111111101111111110111111111
11111111111111111011011111111111111111111111111101111011110111111111011111110111111120000000000000011110111101011011111111111111011111101101111111111111101111111110111111111
11111111111111111011011111111111111111111111111101111011110111111111011111110111111120000000000000000000000001011011111111111111011111101101111111111111101111111110111111111
11111111111111110111011111111111111111111111111101110011110111111111011111110111111120110110110110111111111001011011111111111111011111101101111111111111101111111110111111111
11111111111111110111011111111111111111111111111100001111110111111111011111110111111110110110101101111111111001011011111111111111011111101101111111111111101111111110111111111
11111111111111110111011111111111111111111111111101111111110111111111011111110111111110111010001011111111111000000011111111111111011111100000000000000000000000000000000000000
11111111111111110111011111111111111111111111111101111111110111111111011111110111111111011100000111111111111101011000000000000000011111101101111111111111101111111110111111111
11111111111111110110111111111111111111111111111000000000000000000000002222210111111111101110011111111111111101011102111111111111111111101101111111111111101111111110111111111
11111111111111110110111111111111111111111111111011111111110011111111000000000111111111110101111111111111111101011102111111111111111111101101111111111111101111111110111111111
11111111111111110110111111111111111111111111111011111111110100111120110100001111111111110011111111111111111101011102111111111111111111101101111111111111101111111110111111111
11111111111111110110111111111111111111111111111011111111110111011120111001111111111111110011111111111111111101011101111111111111111111101101111111111111101111110001111111111
11111111111111100100111111111111111111111111111011111111110111101001111101111111111111000101111111111111111101011101111111111111111111101101111111111111101111110111111111111
11111111111111101101111111111111111111111111111011111111110111000111111101111111111110011110111111111111111101011101111111111111111111101101111111111111101111110111111111111
11111111111111011101111111111111111111111111111011111111110110011011111101111111111101111111011111111111111101011101111111111111111111101101111111111111101111110111111111111
11111111111111011011111111111111111111111111111011111111112001111100111101111111110011111111101111111111111101011101111111111111111111101101111111111111101111110111110000000
11111111111111011011111111111111111111111111111011111111112111111110111101111111100111111111101111111111111101011101111111111111111111101101111111111111101111110111100111111
11111111111111010111111111111111111111111111111011111111112000000000000001111111001111111111110111111111111101011101111111111111111111101101111111111111101111110111101111111
11111111111111010111111111111111111111111111111011111111112001111111111101111110111111111111111011111111111101011101111111111111111111101101111111111111101111110000001111111
11111111111111010111111111111111111111111111111011111111112110001111111101111101111111111111111011111111111101011101111111110000001111101101111111111111101111111111101111111
11111111111111010111111111111111111111111111111011111111110111110011111101111001111111111111111011111111111101000000000000000111101111101101111111111111101111111111101111111
11111111111110010111111111111111111111111111111011111111110111111100111101111011111111111111111011111111111101011111111111110111101111101101111111111111101111111111101111111
11111111111110110111111111111111111111111111111011111111110000000000000000000011111111111111111011111111111101011111111111110111101111101101111111100000001111111111111111111
11111111111110110111111111111111111111111111111011111111110111112222211000011111111111111111111011111111111101011111111111110111101111101101111111101111101111111111111111111
11111111111110110111111111111111111111111111111011111111110111111111111011100011111111111111111011111111111101011111111111110111100000000000000000001111101111111111111111111
11111111111110110111111111111111111111111100000000000000000111111111111011111100011111111111111011111111111101011111111111110111111111101101111111111111101111111111111111111
11111111111110110111111111111111111111111111111111111111111111111111111011111111100011111111111011111111112201011111111111110111111111101101111111111111101111111111111111111